........*
.XXX.XXX.
.X*....X.
.X.XXX.X.
.X..p....
e..XXXX.X
XX...X...
*X.X.X.X.
...X...X*