*...1...*
....X....
..XX.XX..
....p....
..XX.X..X
.X*.eX...
..XX*XX..
....X....
*...2...*